SO ./assets/south.xpm
NO ./assets/north.xpm
WE ./assets/west.xpm
EA ./assets/east.xpm
DR ./assets/door.xpm

C 118, 198, 255
F 118, 185, 65


111111111111111111111111111111
111111100000000011000000000001
101000000111000000000001111111
100100000000000000000011111111111
111111111011000001110000000000001
100000000011000001110111111111111
11110111111111011100000010001
11110111111111011101010010001
110000DX010101011100000010001
10000000000000011000000100011
100000N00000000011010100100011
1100000111010101111101110000011
111101111110101101111101000111
111111111111111111111111111111

