1111111111111111111111111111111111
1E1111111X00000C00001C000000000001
100000001000000000001000000000X001
1111100010000000000000000000000001
1000000010000000000011111111101111
1000000000000000000000000000000001
1010010000000000000000011100100101
1010010000011001000001010000100101
1010010000100100100010011X00100101
101001000010010001C10001000010C101
1010011110011000001000011100111101
1000000000000000000000000000000001
1000000000000000000000010001000001
1000000000000000001000111C11100001
1000011111111000001000011111C00001
100001X000000000001000001110000001
100001000000000000100000010000X001
1P0001000000000C00100C000000000001
1111111111111111111111111111111111
