1111111111111111111111111111111111111111111111111111111
10000000000C0000000000001000000000000000000000000000001
1000000000000000000000001000000X0000000000000000C000001
1000000000000000000000001000000000000000000000000000001
1000000000000000000000001111111111111111111111000000001
1111100000000000000000001111111111111111111111000000001
1000000000000000000000000000000000000000000000000000001
1000000000000000000000000000000000000000000000000000001
1000000000000000000000000000000000000000000000000000001
1000000000000000000000000111111111111111111111100000001
1000000000P00000000000000111111111111111111111100000001
1000000000000000000000000111111111111111111111100000001
1000000000000000000000000000000000000000000000000000001
1000000000000000000000000000000000000000000000000000001
1000000000000000000000000000000000000000000000000000001
1111111111111111111111111111111111111111000000000000001
1111111111111111111111111111111111111111000000000000001
11111111111111111111111111111111111E1111000000000000001
10000000C0000000000000000000000000000000000000000000001
10000000000000000000000000000000000000000000000000X0001
1000000000000000000000000000000000000000000000000000001
1000000000000000000000000000000000000000000000000000001
1000000111111111111111111111000000000000000000000000001
1000000000000000000000000111000000000000000000000000001
10000000000000000000000001110000000000000000000C0000001
1000000000000000000000000111000000000000000000000000001
10000000000000000C0000000111000000000000000000000000001
1111111111111111111111111111111111111111111111111111111
